212212212221
221212122212
201222221012
120121220120
221022112201
012212201022
202121122211
122220222210
022211120102
212022211222
012122021202
122221222210