222212212221
222222222212
221222221012
120221222122
221222222201
012212221022
222122222212
122220222212
022222222102
212022212222
012122222202
122221222210