212212212221
221212122212
221222221012
120121222120
221222112211
012212201022
202121122211
122222222210
022211122102
212122211222
012122021202
122221222210